....@.#....
.....###...
......#....
...........
...........
...........
...........